1111111111111111111111111111
1000000000000000000000000001
1011111001111000111000111001
1000100001221001121100101101
1000100001110011222110111001
1000100001001001121100100001
1000100001000100111000100001
1000000000000000000000000001
1000000000000000000000000001
1001110011100011100100000001
1001000112110112110100000001
1001000112110112110100000001
1001110011100011100111100001
1000000000000000000000000001
1011100000111001110000011101
1010000000100000010000000101
1010110100000000000010110101
1000000100111111110010000001
1000011100000000000011100001
1000000000000000000000000001
1001110000001110000011100001
1001110000011100000011100001
1001000000110000000010000001
1001111001100000000011110001
1001111001100000000011110001
1001000000110000000010000001
1001110000011100000011100001
1001110000001110000011100001
1000000000000000000000000001
1000000000000000000000000001
1111111111111111111111111111