1111111111111111111111111111
1000000000000110000000000001
1011110110110110110110111101
1010000110110110110110000101
1010010110110110110110100101
1000010000000000000000100001
1011110111111111111110111101
1011110000111111110000111101
1000000110000110000110000001
1111110111110110111110111111
2222210111110110111110122222
2222210110000000000110122222
2222210110110000110110122222
1111110110000000000110111111
0000000000100000010000000000
1111110110000000000110111111
2222210110111111110110122222
2222210110000000000110122222
2222210110111001110110122222
1111110110110000110110111111
1000000000000110000000000001
1111111111110110111111111111
1111111111110110111111111111
1000110000000000000000110001
1010110110111111110110110101
1010110110111111110110110101
1000000110000110000110000001
1011111111110110111111111101
1011111111110110111111111101
1000000000000000000000000001
1111111111111111111111111111